test_dungeon_files/101.rlg327
                                                                                
                 ..........######################                               
            .... ..........                     ###                             
            ....#..........                       ##                            
                 ..........                        #                            
                 ..........                        ##                           
                 ..........                         ##                          
                 ..........###....#########          #                          
             ####..........   ....        ###########.........                  
            ##                ....                   .........                  
            #                 ....                   .........                  
            #                 ....        ....       .........                  
            #                 ....        ....       .........                  
            #                 ....        ....       .........                  
            #                 ....        ....#######.........                  
        .....                             ....       .........                  
        .....                             ....                                  
        .....                             ....                                  
                                                                                
                                                                                
                                                                                
test_dungeon_files/102.rlg327
                                                                                
                                        ################                        
             ##..............############ #            ##                       
             # ..............             #             #                       
             # ..............             #             .....############       
            ## ..............             #             .....           #       
          ###  ..............             #             .....           #       
          #    #                          #             .....           #       
    ............                          #             .....###        #       
    ............                          #                    #        #       
    ............                          #                    #        #       
    ............                          #                    ###      #       
                                         ......                  ###    #       
                                         ......                    ##....       
                                         ......                      ....       
                                         ......                      ....       
                                                                     ....       
                                                                     ....       
                                                                     ....       
                                                                                
                                                                                
test_dungeon_files/103.rlg327
                                                                                
                                                                                
                                                                                
                                                                                
                                                                                
      .......                                                                   
      .......                                                                   
      .......                                                                   
      .......                                                                   
            #                                                                   
            #       ..............                                              
            #     ##..............                                              
            ########..............                                              
            #  ##   ..............##....                                        
       ...... ##    ..............  ....                                        
       ......###                    ....                                        
               ..............       ....                                        
               ..............                                                   
                                                                                
                                                                                
                                                                                
test_dungeon_files/104.rlg327
                                                                                
                                                                                
                                                                                
                                                                                
                                                                                
                                                       .......                  
                                                       .......                  
                    .........                          .......                  
                    .........                          #  #                     
               .... .........##########                #  #                     
               .... .........         #                #  #                     
               .... .........         #                #  #                     
               ....#.........#########......###############                     
               ....#.........         ......              #                     
               ....                   ......              ###....               
               ....                   ......                 ....               
               ....                   ......                 ....               
                                      ......                                    
                                                                                
                                                                                
                                                                                
test_dungeon_files/105.rlg327
                                                                                
                         .......###################################             
                         .......                                  #             
                         .......           .......                #             
        ......           #                 .......                #             
        ......############                 .......                #             
                   ##    #                 .......                ##            
                    ##   #                 .......                 #            
                     ##  #            #####.......                 ##           
                      ## #           ##          #                  ###         
                       ###          ##           #                    ##        
                         ############            #                     ###      
                                                 #                       ###    
                                                 #                         #    
                                                 #                       ....   
                                                 #########.......        ....   
                                                          .......        ....   
                                                          .......########....   
                                                                                
                                                                                
                                                                                
test_dungeon_files/106.rlg327
                                                                                
       ....     #############################################          .....    
       .... #####                                           ###########.....    
       ....##    .......   ........                ........            .....    
       ....      .......   ........                ........            #        
       ....     #.......   ........                ........            #        
       ....     #          ........                ........            #        
       ....     #          ........                ........            #        
       ....     #          ........                ........            #        
          #     #          ........                ........            #        
          #     #      ####........#####           ........            #        
          ..............               ##             #               .....     
          ..............                ##      ..............        .....     
          ..............                 ###    ..............        .....     
          ..............                   #####..............        .....     
          ..............                        ..............########.....     
          ..............                        ..............        .....     
          ..............                        ..............        .....     
          ..............                                              .....     
                                                                                
                                                                                
test_dungeon_files/107.rlg327
                                                                                
                                                                                
                                                                                
                                                                                
                                                                                
                                         #########..........                    
         ..........                      #        ..........                    
         ..........###########......######        ..........                    
         ..........           ......                                            
         ..........           ......                                            
         ..........           ......                                            
         ..........           ......                                            
         ..........           ......                                            
         ..........           ......                                            
                  #             #                                               
                  #######........                                               
                         ........                                               
                         ........####....                                       
                                     ....                                       
                                                                                
                                                                                
test_dungeon_files/108.rlg327
                                                                                
 ......                                    ......                               
 ......                              ....##......                               
 ......                              ....  ......                               
 ......###                   ########....  ......                               
 ......  #                  ##             ......                               
  #      ####               #                   #                               
  #         #               #                   #                               
  .....     ##              #                   ##                              
  .....      ######################################                             
  .....                    ##                     ##                            
  #                        #                       ##                           
  #                       ##                        #                           
  #                       #                         ##                          
  #              ##########                          ###...........             
  ...........#####                                      ...........             
  ...........                                           ...........             
  ...........                                           ...........             
                                                        ...........             
                                                                                
                                                                                
test_dungeon_files/109.rlg327
                                                                                
                                                                                
                        ....                                                    
                        ....                                                    
             ###########....#######################################             
             #          ....                                      ###########   
         #####          ....                         ....                   #   
         #              ....##                 ######....###########.........   
       ....          ####    #                 #                    .........   
       ....###########       #                 #                    .........   
                             #               ###                    .........   
                             ##    ......#####                                  
                              #####......                                       
                                   ......                                       
                                   ......                                       
                                                                                
                                                                                
                                                                                
                                                                                
                                                                                
                                                                                
test_dungeon_files/110.rlg327
                                                                                
                                                                                
                                                                    .......     
                                                                    .......     
                                                       ......       .......     
                                  .....                ......       .......     
                                  .....                ......       .......     
                 ........         .....           #####......       .......     
                 ........         .....           #         #       .......     
                 ........         .....           #        .......##.......     
         .....###........         .....#####.......########.......    #         
         .....   ........#########.....     .......        .......    #         
         .....   ........ #                 .......        .......    #         
         .....   ........ #                                .......   ##         
         .....   ........ #                                .......####          
         .....###        ##                                                     
                ##########                                                      
                                                                                
                                                                                
                                                                                
                                                                                
